111111
1P0001
111101
1C1101
1E1001
111111
