111111
1P0C01
101X01
1C0001
1E0001
111111
