111111
1P0001
1110E1
1C1001
111001
111111
