111111
1P0C01
1E1001
1C0001
1E0001
111111
