111111
1P0001
101001
100001
1E0001
111111
