1111111111
1P00CEC011
1011111111
10C0000C01
1111111111