1111111111
1P00C0C0E1
1011111101
10C0000C01
1111111111