111111
1P0P01
101001
1C0001
1E0001
111111
