111111
100C01
101001
1C0001
1E0001
111111
