111111
1P0C01
101001
1C0001
1E000111
111111
